....................
....................
#################...
................#...
................#...
..###############...
..#.................
..#.................
..#...#####...######
..#...#...#...#.....
..#...#...#...#.....
..#...#...#####.....
..#...#.............
..#...#.............
..#...###########...
..#.............#...
..#.............#...
..###############...
....................
....................
